11111111111111111111111111111111111111
1P000000111000000111000000CCC000000111
10001100111111100111111100111000000111
11111100111111100111111100111111100111
11111100CCCC00000111100000111111100111
11111100111100000111100000111111100111
11111100111111100111111100111111100111
11111100111111100111111100111111100111
11111100111000000CCC00000011111110E111
11111111111111111111111111111111111111
