11111111111111111
1P00100001C00CN01
10C00NCC00N0C0001
1NC01111111111101
10N01111111111101
10CN00C00NCCNC0E1
11111111111111111