1111111111
1CNNNNN0P1
11111NNNN1
1ENNNNNNN1
1111111111
