11111111111111111111111111111111111111
111111111111111111111111111111111111E1
100000000000000000000000000000000000N1
1N111111111111111111111111111111111111
10000000CCCCCCCCCCCCCCCCCCCCC000000001
111111111111111111111111111111111111N1
10000000000000000000000000000000000001
1N111111111111111111111111111111111111
10000000CCCCCCCCCCCCCCCCCCCCC000000001
111111111111111111111111111111111111N1
10000000000000000000000000000000000001
1N111111111111111111111111111111111111
10000000CCCCCCCCCCCCCCCCCCCCC0000000P1
11111111111111111111111111111111111111
