1111111111111111111111111111111111
1000N000000000000000000000N0000001
10C0N000000000000000000000N000P001
10C0N00000CCCCCCCCCCCCCCCCN0000001
10C0N000000000000000000000NNNNNNN1
10C0N00000CCCCCCCCCCCCCCCC00000001
1E00N0000NNNNNNNNNNNNNNNNNN0000001
10C0N0000NCCCCCCCCCCCCCCCCN0000001
10C0N0000NNNNNNNNNNNNNNNNNN0000001
10C0N00000000000000000000000000001
10C0N00000000000000000000000000001
1111111111111111111111111111111111