11111111111111111111111111111111111111
1N0P000N00000CN00000000000N00000000001
1N000000000000CN00000000000000000000N1
1N111111111111111111111111111111111111
10000000000000000N00000C000000000000N1
111111111111111111111111111111111111N1
100000000NC0000000000000000000000000N1
10111111111111111111111111111111111111
10000000000000000000000NC0000000000001
111111111111111111111111111111111111N1
10000000C0000000000000000000000000N001
10111111111111111111111111111111111111
10000000000000000000000NCCCCCCCCCCCNE1
11111111111111111111111111111111111111