11111111111111
1ENNNNNNNNNNN1
1NNNNNNNNNNNN1
1NNNNNCNNNNNP1
11111111111111