111111111111111111111111111111111111
111P00000000010010000000000000000001
11000000CCCC1C10C1CCCCCCCCCCCC000001
111110000000000010000000000000000001
100000100000000000000000000000000001
1000100000000000000N000000000000NNN1
1001C000000000000000000000000000NEN1
111111111111111111111111111111111111